NO ./img/north.xpm
SO ./img/south.xpm
WE ./img/west.xpm
EA ./img/east.xpm

C 225,30,255
F 220,100,0



111111111111111111111111111111111111111111111111111111111111111111111111111111
111111111111111111111111111111111111111111111111111111111111111111111111111111
111111111111111111111111111111111111111111111111111111111111111111111111111111
111111111111111111111111111111111111111111111000000000000000000000000000001111
111111111111111111111111111111111111110000000000000000000000000000000000000001
111111111111111111111111111111111000000000000000000000000000000000000000001111
111111111111111111111111111100000000000000000000000000000000000000000000000011
111111111111111111111111000000000000000000000000000000000000000000000000000111
111111111111111111110000000000000000000000000000000000000000000000000000000001
111111111111111111110000000000000000000000000000000000000000000000000000000001
111111111111111100000000000000000000000000000000000000000000000000000000000001
111111111111111100000000000000000000000000000000000000000000000000000000000001
111111111111000000000000000000000000000000000000000000000000000000000000000001
111111111111000000000000000000000000000000000000000000000000000000000000000001
111111111111000000000000000000000000000000000000000000000000000000000000000001
111111110000000000000000000000000000000000000000000000000000000000000000000001
111111110000000000000000000000000000000000000000000000000000000000000000000001
111111110000000000000000000000000000000000000000000000000000000000000000000001
111110000000000000000000000000000000000000000000000000000000000000000000000001
111110000000000000000000000000000000000000000000000000000000000000000000000001
111110000000000000000000000000000000000000000000000000000000000000000000000001
111100000000000000000000000000000000000000000000000000000000000000000000000001
11110000000000000000000000W000000000000000000000000000000000000000000000000001
111100000000000000000000000000000000000000000000000000000000000000000000000001
111100000000000000000000000000000000000000000000000000000000000000000000000001
111000000000000000000000000000000000000000000000000000111111111111111111111111
111000000000000000000000000000000000000000000000000010000000000000000000000001
111000000000000000000000000000000000000000000000000010000000000000000000000001
111000000000000000000000000000000000000000000000000010000000000000000000000001
111000000000000000000000000000000000000000000000000001000000000000000000000011
111000000000000000000000000000000000000000000000000010000000000000000000000001
111000000000000000000000000000000000000000000000000010000000000000000000000001
111000000000000000000000000000000000000000000000000010000000000000000000000001
111000000000000000000000000000000000000000000000000010000000000000000000000001
111000000000000000000000000000000000000000000000000010000000000000000000000001
111000000000000000000000000000000000000000000000000011111111111111111100000001
111100000000000000000000000000000000000000000000000000000000000000001111111111
111100000000000000000000000000000000000000000000000000000000000000000000000001
111100000000000000000000000000000000000000000000000000000000000000000000000001
111100000000000000000000000000000000000000000000000000000000000000000000000001
111110000000000000000000000000000000000000000000000000000000000000000000000001
111111110000000000000000000000000000000000000000000000000000000000000000000001
111111111111000000000000000000000000000000000000000000000000000000000000000001
111111111111111111111111111111111111111111111111111111111111111111111111111111